
F 		204, 237,57 
NO 				./asset/wall_n.xpm
			SO ./asset/wall_s.xpm
WE 						./asset/wall_w.xpm
EA ./asset/wall_e.xpm

C 172,21,237


1111111111
1000000001
1111000001
100000W001
1000001001
1010001011
1000010101
1111111111
